MMM222222222222
MPPPPPBPPPPBPP2
2PPBBPPMMMPPMM2
2MMMMMMMPBMPBP2
2PPPBPPPMPMMPP2
2PMMMMMMMPBPMP2
2PBPPPBPPPMPBP2
2PMMMMPMMMMMMM2
2PPBBPPBPPBPPPM
222222222222MMM