223 32222222222
2PPPPPBPPPPBPP2
2PPBBPPMMMPPMM2
2MMMMMMMPBPPBP2
2PPPBPPPMPMMPP2
2PMMMMMMMPBPMP2
2PBPPPBPPPMPBP2
2PMMMMPMMMMMMM2
2PPBBPPBPPBPPPM
222222222222MMM