MMMMM111111111111
MMMMPPPPPPBPBBPP1
MMMBPBBPPBBBBBPP1
MMPBPPPPPBPBBPPP1
MPPPBPPBBPBPPPPP1
1PBPPBBPPBPBPPBP1
1PPBPBPBPPBPBPBP1
1BPBPPBPPPBPPPPP1
1PPPBBPBPPPPBPBP1
1PBPPBPPPBPBPPPP1
1BBBBPPPPPPPPBPPP
111111111111111PP