MMMMPPPPPBBBBBP
MMPPPPPBBBBBBPP
MPPPPPBBBBPBPPP
PPPPBBBBBBBBPPP
PPPBBBPBBBBPPPP
PPBBBBBBBBPPPPP
PPBBBBPBBPPPPPP
PBBPBBBBPPPPPPP
PBBBBBBPPPPPPPP
BBBBPBBPPPPPPPP