11111111111111111
1PPPPPPPPPBPBBPP1
1MMBPBBPPBBBBBPP1
1MPBPPPPPBPBBPPP1
1PPPBPPBBPBPPPPP1
1PBPPBBPPBPBPPBP1
1PPBPBPBPPBPBPBP1
1BPBPPBPPPBPPPPP1
1PPPBBPBPPPPBPBP1
1PBPPBPPPBPBPPPP1
1BBBBPPPPPPPPPPP1
11111111111111111