MMMMPPPPPBPBBPP
MMBPBBPPBBBBBPP
MPBPPPPPBPBBPPP
PPPBPPBBPBPPPPP
PBPPBBPPBPBPPBP
PPBPBPBPPBPBPBP
BPBPPBPPPBPPPPP
PPPBBPBPPPPBPBP
PBPPBPPPBPBPPPP
BBBBPPPPPPPPPPP